* . * * *
* . X S *
* . A * *
* S B * *
* * * * *