* * * * *
* S . S *
* . X . *
* . . S *
* * # * *
